#7
grass.bmp, 0
tree_top.bmp, 1
tree_bot.bmp, 2
ground.bmp, 3
dirt.bmp, 4
rock.bmp, 5
p_idle_front.bmp, 6

(50,52)
11111111111111111111111111111111111111111111111111
22222222222222222222222222222222222222222222222222
11111111111111111111111111111111111111111111111111
22222222222222222222222222222222222222222222222222
11111155544444444433333333333333344444444455111111
22222255444444433333333333333333333334444455222222
11115554444433333333333333333333333333444445551111
22225544433333333333333333333333333333344444552222
11155544333333333333333333333333333333334444555111
22255443333333333333333333333333333333333344455222
11144433333333333333333333333333333333333333444111
22233333333333333333333333333333333333333333344222
11133333333333333333333333333333333333333333344111
22233333333333333333333333333333333000333333334222
11133333333333333333333333333333333000333333334111
22233333300000000333333333333333333000333333333222
11133333300000000333333333333333333000333333333111
22233333300000000333333333333333333000333333333222
11133333333333333333333333333333333000333333333111
22233333333333333333333333333333333000333333333222
11133333333333333333333333344444444000333333333111
22233333333333333333333333344444444000333333333222
11133333333334444444444444444444444000333333333111
22233333333334444444444444444444444000333333333222
11133333333334444444444444444444444000333333333111
22233333333333333333333333333333333333333333333222
11133333333333333333333333333333333333333333333111
22233333333333333333333333333333333333333333333222
11133333333333333333333333333333333333333333333111
22233333333333333333333333333333333333333333333222
11133333333333333333333333333333333333333333333111
22233333333333333333333333333333333333333333333222
11133333333333333333333333333333333333333333333111
22233333333333333333333333333333333333333333333222
11133333333333333333333333333333333333333333333111
22233333333333333333333333333333333333333333333222
11133333333333333333333333333333333333333333333111
22233333333333333333333333333333333333333333333222
11133333333333333333333333333333333333333333333111
22233333333333333333333333333333333333333333333222
11133333333333333333333333333333333333333333333111
22233333333333333333333333333333333333333333333222
11133333333333333333333333333333333333333333333111
22255333333333333333333333333333333333333333355222
11155333333333333333333333333333333333333333355111
22255533333333333333333333333333333333333333555222
11111553333333333333333333333333333333333335511111
22222555333333333333333333333333333333333355522222
11111111111111111111111111111111111111111111111111
22222222222222222222222222222222222222222222222222
11111111111111111111111111111111111111111111111111
22222222222222222222222222222222222222222222222226