#6
grass.bmp, 0
tree_top.bmp, 1
tree_bot.bmp, 2
ground.bmp, 3
dirt.bmp, 4
rock.bmp, 5

(50,52)
11111111111111111111111111111111111111111111111111
22222222222222222222222222222222222222222222222222
11111111111111111111111111111111111111111111111111
22222222222222222222222222222222222222222222222222
11111100000000000000000000000000000000000000111111
22222200000000000000000000000000000000000000222222
11110000000000000000000000000000000000000000001111
22220000000000000000000000000000000000000000002222
11100000000000000000000000000000000000000000000111
22200000000000000000000000000000000000000000000222
11100000000000000000000000000000000000000000000111
22200000000000000000000000000000000000000000000222
11100000000000000000000000000000000000000000000111
22200000000000000000000000000000000000000000000222
11100000000000000000000000000000000000000000000111
22200000000000000000000000000000000000000000000222
11100000000000000000000000000000000000000000000111
22200000000000000000000000000000000000000000000222
11100000000000000000000000000000000000000000000111
22200000000000000000000000000000000000000000000222
11100000000000000000000000000000000000000000000111
22200000000000000000000000000000000000000000000222
11100000000000000000000000000000000000000000000111
22200000000000000000000000000000000000000000000222
11100000000000000000000000000000000000000000000111
22200000000000000000000000000000000000000000000222
11100000000000000000000000000000000000000000000111
22200000000000000000000000000000000000000000000222
11100000000000000000000000000000000000000000000111
22200000000000000000000000000000000000000000000222
11100000000000000000000000000000000000000000000111
22200000000000000000000000000000000000000000000222
11100000000000000000000000000000000000000000000111
22200000000000000000000000000000000000000000000222
11100000000000000000000000000000000000000000000111
22200000000000000000000000000000000000000000000222
11100000000000000000000000000000000000000000000111
22200000000000000000000000000000000000000000000222
11100000000000000000000000000000000000000000000111
22200000000000000000000000000000000000000000000222
11100000000000000000000000000000000000000000000111
22200000000000000000000000000000000000000000000222
11100000000000000000000000000000000000000000000111
22200000000000000000000000000000000000000000000222
11100000000000000000000000000000000000000000000111
22200000000000000000000000000000000000000000000222
11111000000000000000000000000000000000000000011111
22222000000000000000000000000000000000000000022222
11111111111111111111111111111111111111111111111111
22222222222222222222222222222222222222222222222222
11111111111111111111111111111111111111111111111111
22222222222222222222222222222222222222222222222221