#5
grass.bmp, 0
tree.bmp, 1
dirt.bmp, 2
rock.bmp, 3
water.bmp, 4

(8,8)
1 1 1 1 1 1 1 1
1 1 0 0 0 0 1 1
1 0 0 0 0 0 0 1
1 0 0 3 2 0 0 1
1 0 0 3 3 0 0 1
1 0 0 0 0 0 0 1
1 1 0 0 0 0 1 1
1 1 1 1 1 1 1 1
